Che Jeu Temple	Che Jeu Temple
Crisis in the 21st Century Garment Industry and Breakthrough Unified Strategies	David Birnbaum
Timeless Tribute: Arrangements for the Early Advanced Pianist (Lillenas Publications)	Marilynn Ham
Ten Years Beyond Baker Street	Cay Van Ash
Thinking about Law: In Silence with Heidegger	Oren Ben-Dor
Early American Detective Stories: An Anthology	Leroy Lad Panek
Land-use changes and natural reforestation in the Eastern Central Alps [An article from: Agriculture, Ecosystems and Environment]	E. Tasser
The 2007 Japanese Language Proficiency Test Level 1 &amp; 2 Questions and Correct Answers with CD (NIHONGO NORYOKUSHIKEN 1, 2 KYU, Level 1 and 2)	Japan Educational Exchanges and Services (JEES) and The Japan Foundation
Diccionario Biblico Conciso Holman (Spanish Edition)	B&amp;H Espanol Editorial Staff
Frames of Anime: Culture and Image-Building	Tze-yue G. Hu
American Goddess at the Rape of Nanking: The Courage of Minnie Vautrin	Hua-ling Hu
Zahlzerlegungen von Null bis zehn und die mathematische Frühförderung (German Edition)	Decker/ Litke/ Jungklaus/ Reinhardt/ Hod
The Interpreters	George William Russell
Ogun: Ifa and the Spirit of Iron	Awo Fa'lokun Fatunmbi
Die badische Auswanderung im 19. Jahrhundert nach Nordamerika unter besonderer Berücksichtigung des Amtsbezirks Karlsruhe zwischen 1880-1914 (German Edition)	Alexandra Fies
Le Cordon Bleu Complete Cook: Home Collection	France) Cordon Bleu (School : Paris
The Art of Card Making	Claire Sun-ok Choi
BOXING INTERVIEWS OF A LIFETIME	Bad" Brad Berkwitt
Wasteland Book 5: Tales of the Uninvited	Antony Johnston
A Pass and a Prayer (Chip Hilton Sports Series #5)	Clair Bee
Aubergine	CB Potts
Northwest Coast Indians (Native Americans (Heinemann Paperback))	Mir Tamim Ansary
Bipolar and Pregnant: How to Manage and Succeed in Planning and Parenting While Living with Manic Depression	Kristin K. Finn
Communicate with Confidence (Communication Series)	Pamela Jett-Aal
Travellers Book 1: - The Epsilon Queen	Paul Kidd
Candida: Espèces, Pathogénie, Présentation clinique, Diagnostic, Traitement, Résistance, Fréquence d'isolement dans l'hôpital "Hôtel Dieu de France" (French Edition)	Sarah Al Haj Diab
A View from the Horizontal Forest	A. Wake Wachmann Gd.P
An Island of English: Teaching ESL in Chinatown	Danling Fu
Natural Horse-Man-Ship: Six Keys to a Natural Horse-Human Relationship (A Western Horseman Book)	Pat Parelli
Pumpin' Pal's Pocket Guide to Breast Pumping - A 'How To' Breast Pumping Guide for New Moms and Working Moms	Pumpin' Pal
Sixteen Hundred Lines to Pilgrims of the National Society of the Sons and	of the Pilgrims NS Sons and Daughters
National Security Dilemmas: Challenges and Opportunities	Colin S. Gray
Debunking the "Flu Season": Some Other Considerations	MH, ID Newton E. Bunce
An Age of Saints? (Brill's Series on the Early Middle Ages)	Peter Sarris
The Bud Collins History of Tennis: An Authoritative Encyclopedia and Record Book	Bud Collins
Billboard Advertising for Know-It-Alls	For Know-It-Alls
Thunder in the Morning Calm (Pacific Rim Series)	Don Brown
The Oak Leaves (The Oak Leaves Series #1)	Maureen Lang
War Shots: Norm Hatch and the U.S. Marine Corps Combat Cameramen of World War II	Charles Jones
SNAP Magazine Issue 8	FW Publishing
In the Garden of Beasts: Love, Terror, and an American Family in Hitler's Berlin	Erik Larson
Suspense Magazine July 2011	Brad Thor
Das Wesen Des Begriffs Und Des Begreifens; Ein Beitrag Zur Orientierung In Der Wissenschaftlichen Weltanschauung (German Edition)	Dubs Artur
SNK Vs. Capcom: SVC Chaos Volume 1 (Svc Chaos: Snk Vs. Capcom)	Chi Wan Shum
The Original Sudoku Book 2 (Bk. 2)	CC Editors of Nikoli Publishing
D&amp;AD: The Copy Book	D&amp;AD
Le Genie De L'Industrie (1846) (French Edition)	Feu Vanauld
Caucasian Legends	Abraam Abraamovich Gul'bat
NX7.5 Designers Bundle-SAE International Certificate available and 1 year Student NX7.5 Cad License	Aurora CAD Training and Development
The Baja Bash II	Capt. Jim Elfers
Cave Detectives: Unraveling the Mystery of an Ice Age Cave	David L. Harrison
Southeastern View	jw lawson
Mi Primer Libro de Oraciones	Elizabeth Bonner Kea
Manierre Dawson 1887-1969: A Catalogue Raisonne	Myra Bairstow, Ani Boyajian Randy J. Ploog
King of Light: The Book of John Part 1	Young-Rock Lee
Count with Dora! (Dora the Explorer)	Phoebe Beinstein
The True Story of Ah Q (Bilingual Series on Modern Chinese Literature)	Lu Xun
El Enigma de Einstein (Spanish Edition)	José Rodrigues Dos Santos
An English-Chinese Medical Dictionary	Wu Jie Ping
Fit	Dr. Lon Kilgore
Constantini Porphyrogeniti Imperatoris De Cerimoniis Aulae Byzantinae V2, Book 2, Part 1: Graece Et Latine (1830) (Latin Edition)	Io. Iac. Reiskii
Kill Me If You Can	James Patterson
Integrating the European Product Market: Some Evidence of Remaining Obstacles	Adja Awa Sissoko
Rotten Bodies / Idealized Masculinities: Reconstructing Hegemonic Masculinity Through Militarized Medical Discourse in Turkey	Alp Biricik
Sleeping, Dreaming, and Dying: An Exploration of Consciousness	His Holiness the Dalai Lama
Histoire Abrégée De L'église Métropolitaine D'utrecht, Jusqu'à Présent [By G. Du Pac De Bellegarde]. (French Edition)	Gabriel Du Pac De Bellegarde
No Remorse: The Rise and Fall of the Killer John Wallace	Dot Moore
Charlotte Figg Takes Over Paradise	Joyce Magnin
Oncology of Infancy and Childhood: Expert Consult - Online and Print	Stuart H. Orkin MD
Mooring Equipment Guidelines: MEG3	Oil Companies International Marine Forum
The Search for the Million$$$ Dollar Ghost	Heide AW Kaminski
The Holy Bible: The Authorized King James Version (KJV) Old and New Testaments [illustrated]	Holy Bible
Lockjaw &amp; the Pet Avengers Unleashed (Lockjaw and the Pet Avengers)	Chris Eliopoulis
Do-Gooders	Bruce Ey
Gemmology, Third Edition	Peter Read C Eng MIEE FGA DGA
Slim and Scrumptious: More Than 75 Delicious, Healthy Meals Your Family Will Love	Joy Bauer
Intervention Architecture: Building for Change	Aga Khan Foundation
The Beloved Land (Song of Acadia #5)	T. Bunn
Fall Out Boy - From Under the Cork Tree (Guitar Recorded Versions)	Fall Out Boy
Legend of Freedom Hill	Linda Jacobs Altman
The United States Department of Homeland Security: An Overview (2nd Edition) (Pearson Criminal Justice)	CW Productions Ltd.
2003 Mosby's Nursing Drug Reference (Book + Mini CD-ROM for Windows)	Linda Skidmore-Roth RN  MSN  NP
The City Of Ibadan	P. C. Lloyd
Whiplash, Headache, and Neck Pain: Research-Based Directions for Physical Therapies	Gwendolen Jull PhD  MPhty  Grad Dip Man Ther  FACP
